"Date";"Days from today";"ETU caseload";"Nurses and paramedics";"Hygienists and nurses aids";"Doctors";"Support staff";"Total"
"2015-04-15";"168";"178923";"89462";"89462";"17892";"178923";"375739"
"2015-04-14";"167";"178946";"89473";"89473";"17895";"178946";"375787"
"2015-04-13";"166";"178903";"89452";"89452";"17890";"178903";"375697"
"2015-04-12";"165";"178795";"89398";"89398";"17880";"178795";"375471"
"2015-04-11";"164";"178621";"89310";"89310";"17862";"178621";"375103"
"2015-04-10";"163";"178380";"89190";"89190";"17838";"178380";"374598"
"2015-04-09";"162";"178071";"89036";"89036";"17807";"178071";"373950"
"2015-04-08";"161";"177696";"88848";"88848";"17770";"177696";"373162"
"2015-04-07";"160";"177252";"88626";"88626";"17725";"177252";"372229"
"2015-04-06";"159";"176741";"88370";"88370";"17674";"176741";"371155"
"2015-04-05";"158";"176162";"88081";"88081";"17616";"176162";"369940"
"2015-04-04";"157";"175515";"87758";"87758";"17552";"175515";"368583"
"2015-04-03";"156";"174801";"87400";"87400";"17480";"174801";"367081"
"2015-04-02";"155";"174020";"87010";"87010";"17402";"174020";"365442"
"2015-04-01";"154";"173173";"86586";"86586";"17317";"173173";"363662"
"2015-03-31";"153";"172259";"86130";"86130";"17226";"172259";"361745"
"2015-03-30";"152";"171280";"85640";"85640";"17128";"171280";"359688"
"2015-03-29";"151";"170237";"85118";"85118";"17024";"170237";"357497"
"2015-03-28";"150";"169130";"84565";"84565";"16913";"169130";"355173"
"2015-03-27";"149";"167961";"83980";"83980";"16796";"167961";"352717"
"2015-03-26";"148";"166731";"83366";"83366";"16673";"166731";"350136"
"2015-03-25";"147";"165440";"82720";"82720";"16544";"165440";"347424"
"2015-03-24";"146";"164091";"82046";"82046";"16409";"164091";"344592"
"2015-03-23";"145";"162685";"81342";"81342";"16268";"162685";"341637"
"2015-03-22";"144";"161224";"80612";"80612";"16122";"161224";"338570"
"2015-03-21";"143";"159709";"79854";"79854";"15971";"159709";"335388"
"2015-03-20";"142";"158141";"79070";"79070";"15814";"158141";"332095"
"2015-03-19";"141";"156524";"78262";"78262";"15652";"156524";"328700"
"2015-03-18";"140";"154858";"77429";"77429";"15486";"154858";"325202"
"2015-03-17";"139";"153145";"76572";"76572";"15314";"153145";"321603"
"2015-03-16";"138";"151389";"75694";"75694";"15139";"151389";"317916"
"2015-03-15";"137";"149590";"74795";"74795";"14959";"149590";"314139"
"2015-03-14";"136";"147752";"73876";"73876";"14775";"147752";"310279"
"2015-03-13";"135";"145876";"72938";"72938";"14588";"145876";"306340"
"2015-03-12";"134";"143965";"71982";"71982";"14396";"143965";"302325"
"2015-03-11";"133";"142020";"71010";"71010";"14202";"142020";"298242"
"2015-03-10";"132";"140045";"70022";"70022";"14004";"140045";"294093"
"2015-03-09";"131";"138042";"69021";"69021";"13804";"138042";"289888"
"2015-03-08";"130";"136012";"68006";"68006";"13601";"136012";"285625"
"2015-03-07";"129";"133960";"66980";"66980";"13396";"133960";"281316"
"2015-03-06";"128";"131886";"65943";"65943";"13189";"131886";"276961"
"2015-03-05";"127";"129793";"64896";"64896";"12979";"129793";"272564"
"2015-03-04";"126";"127684";"63842";"63842";"12768";"127684";"268136"
"2015-03-03";"125";"125561";"62780";"62780";"12556";"125561";"263677"
"2015-03-02";"124";"123427";"61714";"61714";"12343";"123427";"259198"
"2015-03-01";"123";"121283";"60642";"60642";"12128";"121283";"254695"
"2015-02-28";"122";"119133";"59566";"59566";"11913";"119133";"250178"
"2015-02-27";"121";"116978";"58489";"58489";"11698";"116978";"245654"
"2015-02-26";"120";"114820";"57410";"57410";"11482";"114820";"241122"
"2015-02-25";"119";"112662";"56331";"56331";"11266";"112662";"236590"
"2015-02-24";"118";"110506";"55253";"55253";"11051";"110506";"232063"
"2015-02-23";"117";"108353";"54176";"54176";"10835";"108353";"227540"
"2015-02-22";"116";"106207";"53104";"53104";"10621";"106207";"223036"
"2015-02-21";"115";"104068";"52034";"52034";"10407";"104068";"218543"
"2015-02-20";"114";"101939";"50970";"50970";"10194";"101939";"214073"
"2015-02-19";"113";"99821";"49910";"49910";"9982";"99821";"209623"
"2015-02-18";"112";"97716";"48858";"48858";"9772";"97716";"205204"
"2015-02-17";"111";"95626";"47813";"47813";"9563";"95626";"200815"
"2015-02-16";"110";"93553";"46776";"46776";"9355";"93553";"196460"
"2015-02-15";"109";"91497";"45748";"45748";"9150";"91497";"192143"
"2015-02-14";"108";"89460";"44730";"44730";"8946";"89460";"187866"
"2015-02-13";"107";"87444";"43722";"43722";"8744";"87444";"183632"
"2015-02-12";"106";"85449";"42724";"42724";"8545";"85449";"179442"
"2015-02-11";"105";"83478";"41739";"41739";"8348";"83478";"175304"
"2015-02-10";"104";"81530";"40765";"40765";"8153";"81530";"171213"
"2015-02-09";"103";"79608";"39804";"39804";"7961";"79608";"167177"
"2015-02-08";"102";"77711";"38856";"38856";"7771";"77711";"163194"
"2015-02-07";"101";"75841";"37920";"37920";"7584";"75841";"159265"
"2015-02-06";"100";"73999";"37000";"37000";"7400";"73999";"155399"
"2015-02-05";"99";"72184";"36092";"36092";"7218";"72184";"151586"
"2015-02-04";"98";"70399";"35200";"35200";"7040";"70399";"147839"
"2015-02-03";"97";"68642";"34321";"34321";"6864";"68642";"144148"
"2015-02-02";"96";"66916";"33458";"33458";"6692";"66916";"140524"
"2015-02-01";"95";"65220";"32610";"32610";"6522";"65220";"136962"
"2015-01-31";"94";"63554";"31777";"31777";"6355";"63554";"133463"
"2015-01-30";"93";"61919";"30960";"30960";"6192";"61919";"130031"
"2015-01-29";"92";"60315";"30158";"30158";"6032";"60315";"126663"
"2015-01-28";"91";"58743";"29371";"29371";"5874";"58743";"123359"
"2015-01-27";"90";"57201";"28600";"28600";"5720";"57201";"120121"
"2015-01-26";"89";"55691";"27846";"27846";"5569";"55691";"116952"
"2015-01-25";"88";"54212";"27106";"27106";"5421";"54212";"113845"
"2015-01-24";"87";"52765";"26382";"26382";"5276";"52765";"110805"
"2015-01-23";"86";"51349";"25674";"25674";"5135";"51349";"107832"
"2015-01-22";"85";"49964";"24982";"24982";"4996";"49964";"104924"
"2015-01-21";"84";"48610";"24305";"24305";"4861";"48610";"102081"
"2015-01-20";"83";"47286";"23643";"23643";"4729";"47286";"99301"
"2015-01-19";"82";"45993";"22996";"22996";"4599";"45993";"96584"
"2015-01-18";"81";"44730";"22365";"22365";"4473";"44730";"93933"
"2015-01-17";"80";"43497";"21748";"21748";"4350";"43497";"91343"
"2015-01-16";"79";"42294";"21147";"21147";"4229";"42294";"88817"
"2015-01-15";"78";"41120";"20560";"20560";"4112";"41120";"86352"
"2015-01-14";"77";"39974";"19987";"19987";"3997";"39974";"83945"
"2015-01-13";"76";"38857";"19428";"19428";"3886";"38857";"81599"
"2015-01-12";"75";"37769";"18884";"18884";"3777";"37769";"79314"
"2015-01-11";"74";"36707";"18354";"18354";"3671";"36707";"77086"
"2015-01-10";"73";"35673";"17836";"17836";"3567";"35673";"74912"
"2015-01-09";"72";"34666";"17333";"17333";"3467";"34666";"72799"
"2015-01-08";"71";"33685";"16842";"16842";"3368";"33685";"70737"
"2015-01-07";"70";"32730";"16365";"16365";"3273";"32730";"68733"
"2015-01-06";"69";"31800";"15900";"15900";"3180";"31800";"66780"
"2015-01-05";"68";"30894";"15447";"15447";"3089";"30894";"64877"
"2015-01-04";"67";"30014";"15007";"15007";"3001";"30014";"63029"
"2015-01-03";"66";"29157";"14578";"14578";"2916";"29157";"61229"
"2015-01-02";"65";"28323";"14162";"14162";"2832";"28323";"59479"
"2015-01-01";"64";"27512";"13756";"13756";"2751";"27512";"57775"
"2014-12-31";"63";"26724";"13362";"13362";"2672";"26724";"56120"
"2014-12-30";"62";"25958";"12979";"12979";"2596";"25958";"54512"
"2014-12-29";"61";"25212";"12606";"12606";"2521";"25212";"52945"
"2014-12-28";"60";"24488";"12244";"12244";"2449";"24488";"51425"
"2014-12-27";"59";"23784";"11892";"11892";"2378";"23784";"49946"
"2014-12-26";"58";"23100";"11550";"11550";"2310";"23100";"48510"
"2014-12-25";"57";"22436";"11218";"11218";"2244";"22436";"47116"
"2014-12-24";"56";"21790";"10895";"10895";"2179";"21790";"45759"
"2014-12-23";"55";"21163";"10582";"10582";"2116";"21163";"44443"
"2014-12-22";"54";"20554";"10277";"10277";"2055";"20554";"43163"
"2014-12-21";"53";"19963";"9982";"9982";"1996";"19963";"41923"
"2014-12-20";"52";"19388";"9694";"9694";"1939";"19388";"40715"
"2014-12-19";"51";"18831";"9416";"9416";"1883";"18831";"39546"
"2014-12-18";"50";"18289";"9144";"9144";"1829";"18289";"38406"
"2014-12-17";"49";"17764";"8882";"8882";"1776";"17764";"37304"
"2014-12-16";"48";"17253";"8626";"8626";"1725";"17253";"36230"
"2014-12-15";"47";"16758";"8379";"8379";"1676";"16758";"35192"
"2014-12-14";"46";"16277";"8139";"8139";"1628";"16277";"34183"
"2014-12-13";"45";"15811";"7906";"7906";"1581";"15811";"33204"
"2014-12-12";"44";"15358";"7679";"7679";"1536";"15358";"32252"
"2014-12-11";"43";"14919";"7460";"7460";"1492";"14919";"31331"
"2014-12-10";"42";"14492";"7246";"7246";"1449";"14492";"30433"
"2014-12-09";"41";"14079";"7040";"7040";"1408";"14079";"29567"
"2014-12-08";"40";"13677";"6839";"6839";"1368";"13677";"28723"
"2014-12-07";"39";"13288";"6644";"6644";"1329";"13288";"27905"
"2014-12-06";"38";"12910";"6455";"6455";"1291";"12910";"27111"
"2014-12-05";"37";"12543";"6272";"6272";"1254";"12543";"26341"
"2014-12-04";"36";"12188";"6094";"6094";"1219";"12188";"25595"
"2014-12-03";"35";"11843";"5922";"5922";"1184";"11843";"24871"
"2014-12-02";"34";"11508";"5754";"5754";"1151";"11508";"24167"
"2014-12-01";"33";"11184";"5592";"5592";"1118";"11184";"23486"
"2014-11-30";"32";"10869";"5434";"5434";"1087";"10869";"22824"
"2014-11-29";"31";"10563";"5282";"5282";"1056";"10563";"22183"
"2014-11-28";"30";"10267";"5134";"5134";"1027";"10267";"21562"
"2014-11-27";"29";"9979";"4990";"4990";"998";"9979";"20957"
"2014-11-26";"28";"9701";"4850";"4850";"970";"9701";"20371"
"2014-11-25";"27";"9430";"4715";"4715";"943";"9430";"19803"
"2014-11-24";"26";"9168";"4584";"4584";"917";"9168";"19253"
"2014-11-23";"25";"8914";"4457";"4457";"891";"8914";"18719"
"2014-11-22";"24";"8667";"4334";"4334";"867";"8667";"18202"
"2014-11-21";"23";"8427";"4214";"4214";"843";"8427";"17698"
"2014-11-20";"22";"8195";"4098";"4098";"820";"8195";"17211"
"2014-11-19";"21";"7970";"3985";"3985";"797";"7970";"16737"
"2014-11-18";"20";"7751";"3876";"3876";"775";"7751";"16278"
"2014-11-17";"19";"7540";"3770";"3770";"754";"7540";"15834"
"2014-11-16";"18";"7334";"3667";"3667";"733";"7334";"15401"
"2014-11-15";"17";"7135";"3567";"3567";"714";"7135";"14983"
"2014-11-14";"16";"6941";"3470";"3470";"694";"6941";"14575"
"2014-11-13";"15";"6753";"3376";"3376";"675";"6753";"14180"
"2014-11-12";"14";"6571";"3285";"3285";"657";"6571";"13798"
"2014-11-11";"13";"6395";"3198";"3198";"640";"6395";"13431"
"2014-11-10";"12";"6223";"3112";"3112";"622";"6223";"13069"
"2014-11-09";"11";"6057";"3028";"3028";"606";"6057";"12719"
"2014-11-08";"10";"5896";"2948";"2948";"590";"5896";"12382"
"2014-11-07";"9";"5739";"2870";"2870";"574";"5739";"12053"
"2014-11-06";"8";"5588";"2794";"2794";"559";"5588";"11735"
"2014-11-05";"7";"5440";"2720";"2720";"544";"5440";"11424"
"2014-11-04";"6";"5297";"2648";"2648";"530";"5297";"11123"
"2014-11-03";"5";"5159";"2580";"2580";"516";"5159";"10835"
"2014-11-02";"4";"5024";"2512";"2512";"502";"5024";"10550"
"2014-11-01";"3";"4893";"2446";"2446";"489";"4893";"10274"
"2014-10-31";"2";"4767";"2384";"2384";"477";"4767";"10012"
"2014-10-30";"1";"4644";"2322";"2322";"464";"4644";"9752"
"2014-10-29";"0";"4524";"2262";"2262";"452";"4524";"9500"
"2014-10-28";"-1";"4408";"2204";"2204";"441";"4408";"9257"
"2014-10-27";"-2";"4296";"2148";"2148";"430";"4296";"9022"
"2014-10-26";"-3";"4186";"2093";"2093";"419";"4186";"8791"
"2014-10-25";"-4";"4080";"2040";"2040";"408";"4080";"8568"
"2014-10-24";"-5";"3977";"1989";"1989";"398";"3977";"8353"
"2014-10-23";"-6";"3878";"1939";"1939";"388";"3878";"8144"
"2014-10-22";"-7";"3780";"1890";"1890";"378";"3780";"7938"
"2014-10-21";"-8";"3686";"1843";"1843";"369";"3686";"7741"
"2014-10-20";"-9";"3595";"1798";"1798";"360";"3595";"7551"
"2014-10-19";"-10";"3506";"1753";"1753";"351";"3506";"7363"
"2014-10-18";"-11";"3420";"1710";"1710";"342";"3420";"7182"
"2014-10-17";"-12";"3336";"1668";"1668";"334";"3336";"7006"
"2014-10-16";"-13";"3254";"1627";"1627";"325";"3254";"6833"
"2014-10-15";"-14";"3175";"1588";"1588";"318";"3175";"6669"
"2014-10-14";"-15";"3098";"1549";"1549";"310";"3098";"6506"
"2014-10-13";"-16";"3024";"1512";"1512";"302";"3024";"6350"
"2014-10-12";"-17";"2951";"1476";"1476";"295";"2951";"6198"
"2014-10-11";"-18";"2881";"1440";"1440";"288";"2881";"6049"
"2014-10-10";"-19";"2812";"1406";"1406";"281";"2812";"5905"
"2014-10-09";"-20";"2746";"1373";"1373";"275";"2746";"5767"
"2014-10-08";"-21";"2681";"1340";"1340";"268";"2681";"5629"
"2014-10-07";"-22";"2618";"1309";"1309";"262";"2618";"5498"
"2014-10-06";"-23";"2557";"1278";"1278";"256";"2557";"5369"
"2014-10-05";"-24";"2498";"1249";"1249";"250";"2498";"5246"
"2014-10-04";"-25";"2440";"1220";"1220";"244";"2440";"5124"
"2014-10-03";"-26";"2384";"1192";"1192";"238";"2384";"5006"
"2014-10-02";"-27";"2329";"1164";"1164";"233";"2329";"4890"
"2014-10-01";"-28";"2276";"1138";"1138";"228";"2276";"4780"
"2014-09-30";"-29";"2224";"1112";"1112";"222";"2224";"4670"
"2014-09-29";"-30";"2174";"1087";"1087";"217";"2174";"4565"
"2014-09-28";"-31";"2125";"1062";"1062";"212";"2125";"4461"
"2014-09-27";"-32";"2078";"1039";"1039";"208";"2078";"4364"
"2014-09-26";"-33";"2031";"1015";"1015";"203";"2031";"4264"
"2014-09-25";"-34";"1986";"993";"993";"199";"1986";"4171"
"2014-09-24";"-35";"1942";"971";"971";"194";"1942";"4078"
"2014-09-23";"-36";"1900";"950";"950";"190";"1900";"3990"
"2014-09-22";"-37";"1858";"929";"929";"186";"1858";"3902"
"2014-09-21";"-38";"1818";"909";"909";"182";"1818";"3818"
"2014-09-20";"-39";"1778";"889";"889";"178";"1778";"3734"
"2014-09-19";"-40";"1740";"870";"870";"174";"1740";"3654"
"2014-09-18";"-41";"1702";"851";"851";"170";"1702";"3574"
"2014-09-17";"-42";"1666";"833";"833";"167";"1666";"3499"
"2014-09-16";"-43";"1630";"815";"815";"163";"1630";"3423"
"2014-09-15";"-44";"1595";"798";"798";"160";"1595";"3351"
"2014-09-14";"-45";"1561";"780";"780";"156";"1561";"3277"
"2014-09-13";"-46";"1528";"764";"764";"153";"1528";"3209"
"2014-09-12";"-47";"1496";"748";"748";"150";"1496";"3142"
"2014-09-11";"-48";"1464";"732";"732";"146";"1464";"3074"
"2014-09-10";"-49";"1433";"716";"716";"143";"1433";"3008"
"2014-09-09";"-50";"1403";"702";"702";"140";"1403";"2947"
"2014-09-08";"-51";"1373";"686";"686";"137";"1373";"2882"
"2014-09-07";"-52";"1344";"672";"672";"134";"1344";"2822"
"2014-09-06";"-53";"1316";"658";"658";"132";"1316";"2764"
"2014-09-05";"-54";"1287";"644";"644";"129";"1287";"2704"
"2014-09-04";"-55";"1260";"630";"630";"126";"1260";"2646"
"2014-09-03";"-56";"1232";"616";"616";"123";"1232";"2587"
"2014-09-02";"-57";"1205";"602";"602";"120";"1205";"2529"
"2014-09-01";"-58";"1178";"589";"589";"118";"1178";"2474"
"2014-08-31";"-59";"1151";"576";"576";"115";"1151";"2418"
"2014-08-30";"-60";"1124";"562";"562";"112";"1124";"2360"
"2014-08-29";"-61";"1097";"548";"548";"110";"1097";"2303"
"2014-08-28";"-62";"1070";"535";"535";"107";"1070";"2247"
"2014-08-27";"-63";"1042";"521";"521";"104";"1042";"2188"
"2014-08-26";"-64";"1014";"507";"507";"101";"1014";"2129"
"2014-08-25";"-65";"985";"492";"492";"98";"985";"2067"
"2014-08-24";"-66";"954";"477";"477";"95";"954";"2003"
"2014-08-23";"-67";"922";"461";"461";"92";"922";"1936"
"2014-08-22";"-68";"888";"444";"444";"89";"888";"1865"
"2014-08-21";"-69";"854";"427";"427";"85";"854";"1793"
"2014-08-20";"-70";"821";"411";"411";"82";"821";"1725"
"2014-08-19";"-71";"790";"395";"395";"79";"790";"1659"
"2014-08-18";"-72";"760";"380";"380";"76";"760";"1596"
"2014-08-17";"-73";"731";"366";"366";"73";"731";"1536"
"2014-08-16";"-74";"704";"352";"352";"70";"704";"1478"
"2014-08-15";"-75";"677";"338";"338";"68";"677";"1421"
"2014-08-14";"-76";"652";"326";"326";"65";"652";"1369"
"2014-08-13";"-77";"628";"314";"314";"63";"628";"1319"
"2014-08-12";"-78";"605";"302";"302";"60";"605";"1269"
"2014-08-11";"-79";"583";"292";"292";"58";"583";"1225"
"2014-08-10";"-80";"562";"281";"281";"56";"562";"1180"
"2014-08-09";"-81";"542";"271";"271";"54";"542";"1138"
"2014-08-08";"-82";"523";"262";"262";"52";"523";"1099"
"2014-08-07";"-83";"505";"252";"252";"50";"505";"1059"
"2014-08-06";"-84";"487";"244";"244";"49";"487";"1024"
"2014-08-05";"-85";"470";"235";"235";"47";"470";"987"
"2014-08-04";"-86";"454";"227";"227";"45";"454";"953"
"2014-08-03";"-87";"438";"219";"219";"44";"438";"920"
"2014-08-02";"-88";"423";"212";"212";"42";"423";"889"
"2014-08-01";"-89";"409";"204";"204";"41";"409";"858"
"2014-07-31";"-90";"395";"198";"198";"40";"395";"831"
"2014-07-30";"-91";"382";"191";"191";"38";"382";"802"
"2014-07-29";"-92";"370";"185";"185";"37";"370";"777"
"2014-07-28";"-93";"358";"179";"179";"36";"358";"752"
"2014-07-27";"-94";"346";"173";"173";"35";"346";"727"
"2014-07-26";"-95";"335";"168";"168";"34";"335";"705"
"2014-07-25";"-96";"324";"162";"162";"32";"324";"680"
"2014-07-24";"-97";"314";"157";"157";"31";"314";"659"
"2014-07-23";"-98";"304";"152";"152";"30";"304";"638"
"2014-07-22";"-99";"295";"148";"148";"30";"295";"621"
"2014-07-21";"-100";"285";"142";"142";"28";"285";"597"
"2014-07-20";"-101";"277";"138";"138";"28";"277";"581"
"2014-07-19";"-102";"268";"134";"134";"27";"268";"563"
"2014-07-18";"-103";"260";"130";"130";"26";"260";"546"
"2014-07-17";"-104";"252";"126";"126";"25";"252";"529"
"2014-07-16";"-105";"245";"123";"123";"24";"245";"515"
"2014-07-15";"-106";"237";"118";"118";"24";"237";"497"
"2014-07-14";"-107";"230";"115";"115";"23";"230";"483"
"2014-07-13";"-108";"224";"112";"112";"22";"224";"470"
"2014-07-12";"-109";"217";"108";"108";"22";"217";"455"
"2014-07-11";"-110";"211";"106";"106";"21";"211";"444"
"2014-07-10";"-111";"204";"102";"102";"20";"204";"428"
"2014-07-09";"-112";"198";"99";"99";"20";"198";"416"
"2014-07-08";"-113";"193";"96";"96";"19";"193";"404"
"2014-07-07";"-114";"187";"94";"94";"19";"187";"394"
"2014-07-06";"-115";"181";"90";"90";"18";"181";"379"
"2014-07-05";"-116";"176";"88";"88";"18";"176";"370"
"2014-07-04";"-117";"171";"86";"86";"17";"171";"360"
"2014-07-03";"-118";"165";"82";"82";"16";"165";"345"
"2014-07-02";"-119";"160";"80";"80";"16";"160";"336"
"2014-07-01";"-120";"155";"78";"78";"16";"155";"327"
"2014-06-30";"-121";"150";"75";"75";"15";"150";"315"
"2014-06-29";"-122";"145";"72";"72";"14";"145";"303"
"2014-06-28";"-123";"139";"70";"70";"14";"139";"293"
"2014-06-27";"-124";"134";"67";"67";"13";"134";"281"
"2014-06-26";"-125";"129";"64";"64";"13";"129";"270"
"2014-06-25";"-126";"123";"62";"62";"12";"123";"259"
"2014-06-24";"-127";"118";"59";"59";"12";"118";"248"
"2014-06-23";"-128";"114";"57";"57";"11";"114";"239"
"2014-06-22";"-129";"109";"55";"55";"11";"109";"230"
"2014-06-21";"-130";"105";"52";"52";"10";"105";"219"
"2014-06-20";"-131";"101";"50";"50";"10";"101";"211"
"2014-06-19";"-132";"97";"48";"48";"10";"97";"203"
"2014-06-18";"-133";"93";"46";"46";"9";"93";"194"
"2014-06-17";"-134";"89";"44";"44";"9";"89";"186"
"2014-06-16";"-135";"86";"43";"43";"9";"86";"181"
"2014-06-15";"-136";"83";"42";"42";"8";"83";"175"
"2014-06-14";"-137";"80";"40";"40";"8";"80";"168"
"2014-06-13";"-138";"77";"38";"38";"8";"77";"161"
"2014-06-12";"-139";"74";"37";"37";"7";"74";"155"
"2014-06-11";"-140";"71";"36";"36";"7";"71";"150"
"2014-06-10";"-141";"68";"34";"34";"7";"68";"143"
"2014-06-09";"-142";"66";"33";"33";"7";"66";"139"
"2014-06-08";"-143";"63";"32";"32";"6";"63";"133"
"2014-06-07";"-144";"61";"30";"30";"6";"61";"127"
"2014-06-06";"-145";"59";"30";"30";"6";"59";"125"
"2014-06-05";"-146";"57";"28";"28";"6";"57";"119"
"2014-06-04";"-147";"55";"28";"28";"6";"55";"117"
"2014-06-03";"-148";"53";"26";"26";"5";"53";"110"
"2014-06-02";"-149";"51";"26";"26";"5";"51";"108"
"2014-06-01";"-150";"49";"24";"24";"5";"49";"102"
"2014-05-31";"-151";"47";"24";"24";"5";"47";"100"
