"Date";"Days from today";"ETU caseload";"Nurses and paramedics";"Hygienists and nurses aids";"Doctors";"Support staff";"Total"
"2015-04-15";"168";"10940";"5470";"5470";"1094";"10940";"22974"
"2015-04-14";"167";"10833";"5416";"5416";"1083";"10833";"22748"
"2015-04-13";"166";"10727";"5364";"5364";"1073";"10727";"22528"
"2015-04-12";"165";"10621";"5310";"5310";"1062";"10621";"22303"
"2015-04-11";"164";"10516";"5258";"5258";"1052";"10516";"22084"
"2015-04-10";"163";"10412";"5206";"5206";"1041";"10412";"21865"
"2015-04-09";"162";"10308";"5154";"5154";"1031";"10308";"21647"
"2015-04-08";"161";"10205";"5102";"5102";"1020";"10205";"21429"
"2015-04-07";"160";"10103";"5052";"5052";"1010";"10103";"21217"
"2015-04-06";"159";"10001";"5000";"5000";"1000";"10001";"21001"
"2015-04-05";"158";"9900";"4950";"4950";"990";"9900";"20790"
"2015-04-04";"157";"9800";"4900";"4900";"980";"9800";"20580"
"2015-04-03";"156";"9700";"4850";"4850";"970";"9700";"20370"
"2015-04-02";"155";"9601";"4800";"4800";"960";"9601";"20161"
"2015-04-01";"154";"9502";"4751";"4751";"950";"9502";"19954"
"2015-03-31";"153";"9404";"4702";"4702";"940";"9404";"19748"
"2015-03-30";"152";"9307";"4654";"4654";"931";"9307";"19546"
"2015-03-29";"151";"9211";"4606";"4606";"921";"9211";"19344"
"2015-03-28";"150";"9115";"4558";"4558";"912";"9115";"19143"
"2015-03-27";"149";"9020";"4510";"4510";"902";"9020";"18942"
"2015-03-26";"148";"8926";"4463";"4463";"893";"8926";"18745"
"2015-03-25";"147";"8832";"4416";"4416";"883";"8832";"18547"
"2015-03-24";"146";"8739";"4370";"4370";"874";"8739";"18353"
"2015-03-23";"145";"8647";"4324";"4324";"865";"8647";"18160"
"2015-03-22";"144";"8555";"4278";"4278";"856";"8555";"17967"
"2015-03-21";"143";"8465";"4232";"4232";"846";"8465";"17775"
"2015-03-20";"142";"8375";"4188";"4188";"838";"8375";"17589"
"2015-03-19";"141";"8285";"4142";"4142";"828";"8285";"17397"
"2015-03-18";"140";"8197";"4098";"4098";"820";"8197";"17213"
"2015-03-17";"139";"8109";"4054";"4054";"811";"8109";"17028"
"2015-03-16";"138";"8021";"4010";"4010";"802";"8021";"16843"
"2015-03-15";"137";"7935";"3967";"3967";"794";"7935";"16663"
"2015-03-14";"136";"7849";"3924";"3924";"785";"7849";"16482"
"2015-03-13";"135";"7764";"3882";"3882";"776";"7764";"16304"
"2015-03-12";"134";"7680";"3840";"3840";"768";"7680";"16128"
"2015-03-11";"133";"7596";"3798";"3798";"760";"7596";"15952"
"2015-03-10";"132";"7513";"3756";"3756";"751";"7513";"15776"
"2015-03-09";"131";"7431";"3716";"3716";"743";"7431";"15606"
"2015-03-08";"130";"7349";"3674";"3674";"735";"7349";"15432"
"2015-03-07";"129";"7269";"3634";"3634";"727";"7269";"15264"
"2015-03-06";"128";"7189";"3594";"3594";"719";"7189";"15096"
"2015-03-05";"127";"7109";"3554";"3554";"711";"7109";"14928"
"2015-03-04";"126";"7031";"3516";"3516";"703";"7031";"14766"
"2015-03-03";"125";"6953";"3476";"3476";"695";"6953";"14600"
"2015-03-02";"124";"6875";"3438";"3438";"688";"6875";"14439"
"2015-03-01";"123";"6799";"3399";"3399";"680";"6799";"14277"
"2015-02-28";"122";"6723";"3362";"3362";"672";"6723";"14119"
"2015-02-27";"121";"6648";"3324";"3324";"665";"6648";"13961"
"2015-02-26";"120";"6574";"3287";"3287";"657";"6574";"13805"
"2015-02-25";"119";"6500";"3250";"3250";"650";"6500";"13650"
"2015-02-24";"118";"6427";"3214";"3214";"643";"6427";"13498"
"2015-02-23";"117";"6355";"3178";"3178";"636";"6355";"13347"
"2015-02-22";"116";"6283";"3142";"3142";"628";"6283";"13195"
"2015-02-21";"115";"6212";"3106";"3106";"621";"6212";"13045"
"2015-02-20";"114";"6142";"3071";"3071";"614";"6142";"12898"
"2015-02-19";"113";"6072";"3036";"3036";"607";"6072";"12751"
"2015-02-18";"112";"6003";"3002";"3002";"600";"6003";"12607"
"2015-02-17";"111";"5935";"2968";"2968";"594";"5935";"12465"
"2015-02-16";"110";"5867";"2934";"2934";"587";"5867";"12322"
"2015-02-15";"109";"5801";"2900";"2900";"580";"5801";"12181"
"2015-02-14";"108";"5734";"2867";"2867";"573";"5734";"12041"
"2015-02-13";"107";"5669";"2834";"2834";"567";"5669";"11904"
"2015-02-12";"106";"5604";"2802";"2802";"560";"5604";"11768"
"2015-02-11";"105";"5540";"2770";"2770";"554";"5540";"11634"
"2015-02-10";"104";"5476";"2738";"2738";"548";"5476";"11500"
"2015-02-09";"103";"5413";"2706";"2706";"541";"5413";"11366"
"2015-02-08";"102";"5351";"2676";"2676";"535";"5351";"11238"
"2015-02-07";"101";"5289";"2644";"2644";"529";"5289";"11106"
"2015-02-06";"100";"5228";"2614";"2614";"523";"5228";"10979"
"2015-02-05";"99";"5168";"2584";"2584";"517";"5168";"10853"
"2015-02-04";"98";"5108";"2554";"2554";"511";"5108";"10727"
"2015-02-03";"97";"5049";"2524";"2524";"505";"5049";"10602"
"2015-02-02";"96";"4990";"2495";"2495";"499";"4990";"10479"
"2015-02-01";"95";"4932";"2466";"2466";"493";"4932";"10357"
"2015-01-31";"94";"4875";"2438";"2438";"488";"4875";"10239"
"2015-01-30";"93";"4818";"2409";"2409";"482";"4818";"10118"
"2015-01-29";"92";"4762";"2381";"2381";"476";"4762";"10000"
"2015-01-28";"91";"4706";"2353";"2353";"471";"4706";"9883"
"2015-01-27";"90";"4651";"2326";"2326";"465";"4651";"9768"
"2015-01-26";"89";"4597";"2298";"2298";"460";"4597";"9653"
"2015-01-25";"88";"4543";"2272";"2272";"454";"4543";"9541"
"2015-01-24";"87";"4490";"2245";"2245";"449";"4490";"9429"
"2015-01-23";"86";"4438";"2219";"2219";"444";"4438";"9320"
"2015-01-22";"85";"4385";"2192";"2192";"438";"4385";"9207"
"2015-01-21";"84";"4334";"2167";"2167";"433";"4334";"9101"
"2015-01-20";"83";"4283";"2142";"2142";"428";"4283";"8995"
"2015-01-19";"82";"4233";"2116";"2116";"423";"4233";"8888"
"2015-01-18";"81";"4183";"2092";"2092";"418";"4183";"8785"
"2015-01-17";"80";"4134";"2067";"2067";"413";"4134";"8681"
"2015-01-16";"79";"4085";"2042";"2042";"408";"4085";"8577"
"2015-01-15";"78";"4037";"2018";"2018";"404";"4037";"8477"
"2015-01-14";"77";"3989";"1994";"1994";"399";"3989";"8376"
"2015-01-13";"76";"3942";"1971";"1971";"394";"3942";"8278"
"2015-01-12";"75";"3895";"1948";"1948";"390";"3895";"8181"
"2015-01-11";"74";"3849";"1924";"1924";"385";"3849";"8082"
"2015-01-10";"73";"3804";"1902";"1902";"380";"3804";"7988"
"2015-01-09";"72";"3759";"1880";"1880";"376";"3759";"7895"
"2015-01-08";"71";"3714";"1857";"1857";"371";"3714";"7799"
"2015-01-07";"70";"3670";"1835";"1835";"367";"3670";"7707"
"2015-01-06";"69";"3626";"1813";"1813";"363";"3626";"7615"
"2015-01-05";"68";"3583";"1792";"1792";"358";"3583";"7525"
"2015-01-04";"67";"3541";"1770";"1770";"354";"3541";"7435"
"2015-01-03";"66";"3498";"1749";"1749";"350";"3498";"7346"
"2015-01-02";"65";"3457";"1728";"1728";"346";"3457";"7259"
"2015-01-01";"64";"3416";"1708";"1708";"342";"3416";"7174"
"2014-12-31";"63";"3375";"1688";"1688";"338";"3375";"7089"
"2014-12-30";"62";"3335";"1668";"1668";"334";"3335";"7005"
"2014-12-29";"61";"3295";"1648";"1648";"330";"3295";"6921"
"2014-12-28";"60";"3256";"1628";"1628";"326";"3256";"6838"
"2014-12-27";"59";"3217";"1608";"1608";"322";"3217";"6755"
"2014-12-26";"58";"3178";"1589";"1589";"318";"3178";"6674"
"2014-12-25";"57";"3140";"1570";"1570";"314";"3140";"6594"
"2014-12-24";"56";"3103";"1552";"1552";"310";"3103";"6517"
"2014-12-23";"55";"3066";"1533";"1533";"307";"3066";"6439"
"2014-12-22";"54";"3029";"1514";"1514";"303";"3029";"6360"
"2014-12-21";"53";"2993";"1496";"1496";"299";"2993";"6284"
"2014-12-20";"52";"2957";"1478";"1478";"296";"2957";"6209"
"2014-12-19";"51";"2921";"1460";"1460";"292";"2921";"6133"
"2014-12-18";"50";"2886";"1443";"1443";"289";"2886";"6061"
"2014-12-17";"49";"2852";"1426";"1426";"285";"2852";"5989"
"2014-12-16";"48";"2818";"1409";"1409";"282";"2818";"5918"
"2014-12-15";"47";"2784";"1392";"1392";"278";"2784";"5846"
"2014-12-14";"46";"2750";"1375";"1375";"275";"2750";"5775"
"2014-12-13";"45";"2717";"1358";"1358";"272";"2717";"5705"
"2014-12-12";"44";"2685";"1342";"1342";"268";"2685";"5637"
"2014-12-11";"43";"2652";"1326";"1326";"265";"2652";"5569"
"2014-12-10";"42";"2621";"1310";"1310";"262";"2621";"5503"
"2014-12-09";"41";"2589";"1294";"1294";"259";"2589";"5436"
"2014-12-08";"40";"2558";"1279";"1279";"256";"2558";"5372"
"2014-12-07";"39";"2527";"1264";"1264";"253";"2527";"5308"
"2014-12-06";"38";"2497";"1248";"1248";"250";"2497";"5243"
"2014-12-05";"37";"2467";"1234";"1234";"247";"2467";"5182"
"2014-12-04";"36";"2437";"1218";"1218";"244";"2437";"5117"
"2014-12-03";"35";"2408";"1204";"1204";"241";"2408";"5057"
"2014-12-02";"34";"2379";"1190";"1190";"238";"2379";"4997"
"2014-12-01";"33";"2350";"1175";"1175";"235";"2350";"4935"
"2014-11-30";"32";"2322";"1161";"1161";"232";"2322";"4876"
"2014-11-29";"31";"2294";"1147";"1147";"229";"2294";"4817"
"2014-11-28";"30";"2266";"1133";"1133";"227";"2266";"4759"
"2014-11-27";"29";"2239";"1120";"1120";"224";"2239";"4703"
"2014-11-26";"28";"2212";"1106";"1106";"221";"2212";"4645"
"2014-11-25";"27";"2185";"1092";"1092";"218";"2185";"4587"
"2014-11-24";"26";"2159";"1080";"1080";"216";"2159";"4535"
"2014-11-23";"25";"2132";"1066";"1066";"213";"2132";"4477"
"2014-11-22";"24";"2107";"1054";"1054";"211";"2107";"4426"
"2014-11-21";"23";"2081";"1040";"1040";"208";"2081";"4369"
"2014-11-20";"22";"2056";"1028";"1028";"206";"2056";"4318"
"2014-11-19";"21";"2031";"1015";"1015";"203";"2031";"4264"
"2014-11-18";"20";"2007";"1004";"1004";"201";"2007";"4216"
"2014-11-17";"19";"1983";"991";"991";"198";"1983";"4163"
"2014-11-16";"18";"1959";"980";"980";"196";"1959";"4115"
"2014-11-15";"17";"1935";"968";"968";"194";"1935";"4065"
"2014-11-14";"16";"1912";"956";"956";"191";"1912";"4015"
"2014-11-13";"15";"1888";"944";"944";"189";"1888";"3965"
"2014-11-12";"14";"1866";"933";"933";"187";"1866";"3919"
"2014-11-11";"13";"1843";"922";"922";"184";"1843";"3871"
"2014-11-10";"12";"1821";"910";"910";"182";"1821";"3823"
"2014-11-09";"11";"1799";"899";"899";"180";"1799";"3777"
"2014-11-08";"10";"1777";"888";"888";"178";"1777";"3731"
"2014-11-07";"9";"1755";"878";"878";"176";"1755";"3687"
"2014-11-06";"8";"1734";"867";"867";"173";"1734";"3641"
"2014-11-05";"7";"1713";"856";"856";"171";"1713";"3596"
"2014-11-04";"6";"1693";"846";"846";"169";"1693";"3554"
"2014-11-03";"5";"1672";"836";"836";"167";"1672";"3511"
"2014-11-02";"4";"1652";"826";"826";"165";"1652";"3469"
"2014-11-01";"3";"1632";"816";"816";"163";"1632";"3427"
"2014-10-31";"2";"1612";"806";"806";"161";"1612";"3385"
"2014-10-30";"1";"1593";"796";"796";"159";"1593";"3344"
"2014-10-29";"0";"1573";"786";"786";"157";"1573";"3302"
"2014-10-28";"-1";"1554";"777";"777";"155";"1554";"3263"
"2014-10-27";"-2";"1535";"768";"768";"154";"1535";"3225"
"2014-10-26";"-3";"1517";"758";"758";"152";"1517";"3185"
"2014-10-25";"-4";"1498";"749";"749";"150";"1498";"3146"
"2014-10-24";"-5";"1480";"740";"740";"148";"1480";"3108"
"2014-10-23";"-6";"1462";"731";"731";"146";"1462";"3070"
"2014-10-22";"-7";"1445";"722";"722";"144";"1445";"3033"
"2014-10-21";"-8";"1427";"714";"714";"143";"1427";"2998"
"2014-10-20";"-9";"1410";"705";"705";"141";"1410";"2961"
"2014-10-19";"-10";"1393";"696";"696";"139";"1393";"2924"
"2014-10-18";"-11";"1376";"688";"688";"138";"1376";"2890"
"2014-10-17";"-12";"1359";"680";"680";"136";"1359";"2855"
"2014-10-16";"-13";"1343";"672";"672";"134";"1343";"2821"
"2014-10-15";"-14";"1327";"664";"664";"133";"1327";"2788"
"2014-10-14";"-15";"1310";"655";"655";"131";"1310";"2751"
"2014-10-13";"-16";"1295";"648";"648";"130";"1295";"2721"
"2014-10-12";"-17";"1279";"640";"640";"128";"1279";"2687"
"2014-10-11";"-18";"1263";"632";"632";"126";"1263";"2653"
"2014-10-10";"-19";"1248";"624";"624";"125";"1248";"2621"
"2014-10-09";"-20";"1233";"616";"616";"123";"1233";"2588"
"2014-10-08";"-21";"1218";"609";"609";"122";"1218";"2558"
"2014-10-07";"-22";"1203";"602";"602";"120";"1203";"2527"
"2014-10-06";"-23";"1189";"594";"594";"119";"1189";"2496"
"2014-10-05";"-24";"1174";"587";"587";"117";"1174";"2465"
"2014-10-04";"-25";"1160";"580";"580";"116";"1160";"2436"
"2014-10-03";"-26";"1146";"573";"573";"115";"1146";"2407"
"2014-10-02";"-27";"1132";"566";"566";"113";"1132";"2377"
"2014-10-01";"-28";"1118";"559";"559";"112";"1118";"2348"
"2014-09-30";"-29";"1104";"552";"552";"110";"1104";"2318"
"2014-09-29";"-30";"1091";"546";"546";"109";"1091";"2292"
"2014-09-28";"-31";"1078";"539";"539";"108";"1078";"2264"
"2014-09-27";"-32";"1064";"532";"532";"106";"1064";"2234"
"2014-09-26";"-33";"1051";"526";"526";"105";"1051";"2208"
"2014-09-25";"-34";"1038";"519";"519";"104";"1038";"2180"
"2014-09-24";"-35";"1026";"513";"513";"103";"1026";"2155"
"2014-09-23";"-36";"1013";"507";"507";"101";"1013";"2128"
"2014-09-22";"-37";"1001";"500";"500";"100";"1001";"2101"
"2014-09-21";"-38";"988";"494";"494";"99";"988";"2075"
"2014-09-20";"-39";"976";"488";"488";"98";"976";"2050"
"2014-09-19";"-40";"964";"482";"482";"96";"964";"2024"
"2014-09-18";"-41";"952";"476";"476";"95";"952";"1999"
"2014-09-17";"-42";"940";"470";"470";"94";"940";"1974"
"2014-09-16";"-43";"928";"464";"464";"93";"928";"1949"
"2014-09-15";"-44";"916";"458";"458";"92";"916";"1924"
"2014-09-14";"-45";"904";"452";"452";"90";"904";"1898"
"2014-09-13";"-46";"893";"446";"446";"89";"893";"1874"
"2014-09-12";"-47";"881";"440";"440";"88";"881";"1849"
"2014-09-11";"-48";"869";"434";"434";"87";"869";"1824"
"2014-09-10";"-49";"858";"429";"429";"86";"858";"1802"
"2014-09-09";"-50";"846";"423";"423";"85";"846";"1777"
"2014-09-08";"-51";"834";"417";"417";"83";"834";"1751"
"2014-09-07";"-52";"823";"412";"412";"82";"823";"1729"
"2014-09-06";"-53";"811";"406";"406";"81";"811";"1704"
"2014-09-05";"-54";"799";"400";"400";"80";"799";"1679"
"2014-09-04";"-55";"787";"394";"394";"79";"787";"1654"
"2014-09-03";"-56";"774";"387";"387";"77";"774";"1625"
"2014-09-02";"-57";"761";"380";"380";"76";"761";"1597"
"2014-09-01";"-58";"748";"374";"374";"75";"748";"1571"
"2014-08-31";"-59";"734";"367";"367";"73";"734";"1541"
"2014-08-30";"-60";"720";"360";"360";"72";"720";"1512"
"2014-08-29";"-61";"705";"352";"352";"70";"705";"1479"
"2014-08-28";"-62";"689";"344";"344";"69";"689";"1446"
"2014-08-27";"-63";"672";"336";"336";"67";"672";"1411"
"2014-08-26";"-64";"654";"327";"327";"65";"654";"1373"
"2014-08-25";"-65";"634";"317";"317";"63";"634";"1331"
"2014-08-24";"-66";"612";"306";"306";"61";"612";"1285"
"2014-08-23";"-67";"588";"294";"294";"59";"588";"1235"
"2014-08-22";"-68";"560";"280";"280";"56";"560";"1176"
"2014-08-21";"-69";"532";"266";"266";"53";"532";"1117"
"2014-08-20";"-70";"505";"252";"252";"50";"505";"1059"
"2014-08-19";"-71";"480";"240";"240";"48";"480";"1008"
"2014-08-18";"-72";"456";"228";"228";"46";"456";"958"
"2014-08-17";"-73";"433";"216";"216";"43";"433";"908"
"2014-08-16";"-74";"411";"206";"206";"41";"411";"864"
"2014-08-15";"-75";"390";"195";"195";"39";"390";"819"
"2014-08-14";"-76";"370";"185";"185";"37";"370";"777"
"2014-08-13";"-77";"352";"176";"176";"35";"352";"739"
"2014-08-12";"-78";"334";"167";"167";"33";"334";"701"
"2014-08-11";"-79";"317";"158";"158";"32";"317";"665"
"2014-08-10";"-80";"301";"150";"150";"30";"301";"631"
"2014-08-09";"-81";"286";"143";"143";"29";"286";"601"
"2014-08-08";"-82";"271";"136";"136";"27";"271";"570"
"2014-08-07";"-83";"257";"128";"128";"26";"257";"539"
"2014-08-06";"-84";"244";"122";"122";"24";"244";"512"
"2014-08-05";"-85";"232";"116";"116";"23";"232";"487"
"2014-08-04";"-86";"220";"110";"110";"22";"220";"462"
"2014-08-03";"-87";"209";"104";"104";"21";"209";"438"
"2014-08-02";"-88";"198";"99";"99";"20";"198";"416"
"2014-08-01";"-89";"188";"94";"94";"19";"188";"395"
"2014-07-31";"-90";"178";"89";"89";"18";"178";"374"
"2014-07-30";"-91";"169";"84";"84";"17";"169";"354"
"2014-07-29";"-92";"161";"80";"80";"16";"161";"337"
"2014-07-28";"-93";"153";"76";"76";"15";"153";"320"
"2014-07-27";"-94";"145";"72";"72";"14";"145";"303"
"2014-07-26";"-95";"137";"68";"68";"14";"137";"287"
"2014-07-25";"-96";"130";"65";"65";"13";"130";"273"
"2014-07-24";"-97";"124";"62";"62";"12";"124";"260"
"2014-07-23";"-98";"117";"58";"58";"12";"117";"245"
"2014-07-22";"-99";"111";"56";"56";"11";"111";"234"
"2014-07-21";"-100";"106";"53";"53";"11";"106";"223"
"2014-07-20";"-101";"100";"50";"50";"10";"100";"210"
"2014-07-19";"-102";"95";"48";"48";"10";"95";"201"
"2014-07-18";"-103";"90";"45";"45";"9";"90";"189"
"2014-07-17";"-104";"86";"43";"43";"9";"86";"181"
"2014-07-16";"-105";"81";"40";"40";"8";"81";"169"
"2014-07-15";"-106";"77";"38";"38";"8";"77";"161"
"2014-07-14";"-107";"73";"36";"36";"7";"73";"152"
"2014-07-13";"-108";"69";"34";"34";"7";"69";"144"
"2014-07-12";"-109";"66";"33";"33";"7";"66";"139"
"2014-07-11";"-110";"62";"31";"31";"6";"62";"130"
"2014-07-10";"-111";"59";"30";"30";"6";"59";"125"
"2014-07-09";"-112";"56";"28";"28";"6";"56";"118"
"2014-07-08";"-113";"53";"26";"26";"5";"53";"110"
"2014-07-07";"-114";"50";"25";"25";"5";"50";"105"
"2014-07-06";"-115";"48";"24";"24";"5";"48";"101"
"2014-07-05";"-116";"45";"22";"22";"4";"45";"93"
"2014-07-04";"-117";"43";"22";"22";"4";"43";"91"
"2014-07-03";"-118";"41";"20";"20";"4";"41";"85"
"2014-07-02";"-119";"38";"19";"19";"4";"38";"80"
"2014-07-01";"-120";"36";"18";"18";"4";"36";"76"
"2014-06-30";"-121";"35";"18";"18";"4";"35";"75"
"2014-06-29";"-122";"33";"16";"16";"3";"33";"68"
"2014-06-28";"-123";"31";"16";"16";"3";"31";"66"
"2014-06-27";"-124";"29";"14";"14";"3";"29";"60"
"2014-06-26";"-125";"28";"14";"14";"3";"28";"59"
"2014-06-25";"-126";"26";"13";"13";"3";"26";"55"
"2014-06-24";"-127";"25";"12";"12";"2";"25";"51"
"2014-06-23";"-128";"23";"12";"12";"2";"23";"49"
"2014-06-22";"-129";"22";"11";"11";"2";"22";"46"
"2014-06-21";"-130";"21";"10";"10";"2";"21";"43"
"2014-06-20";"-131";"20";"10";"10";"2";"20";"42"
"2014-06-19";"-132";"19";"10";"10";"2";"19";"41"
"2014-06-18";"-133";"18";"9";"9";"2";"18";"38"
"2014-06-17";"-134";"17";"8";"8";"2";"17";"35"
"2014-06-16";"-135";"16";"8";"8";"2";"16";"34"
"2014-06-15";"-136";"15";"8";"8";"2";"15";"33"
"2014-06-14";"-137";"14";"7";"7";"1";"14";"29"
"2014-06-13";"-138";"13";"6";"6";"1";"13";"26"
"2014-06-12";"-139";"13";"6";"6";"1";"13";"26"
"2014-06-11";"-140";"12";"6";"6";"1";"12";"25"
"2014-06-10";"-141";"11";"6";"6";"1";"11";"24"
"2014-06-09";"-142";"11";"6";"6";"1";"11";"24"
"2014-06-08";"-143";"10";"5";"5";"1";"10";"21"
"2014-06-07";"-144";"9";"4";"4";"1";"9";"18"
"2014-06-06";"-145";"9";"4";"4";"1";"9";"18"
"2014-06-05";"-146";"8";"4";"4";"1";"8";"17"
"2014-06-04";"-147";"8";"4";"4";"1";"8";"17"
"2014-06-03";"-148";"8";"4";"4";"1";"8";"17"
"2014-06-02";"-149";"7";"4";"4";"1";"7";"16"
"2014-06-01";"-150";"7";"4";"4";"1";"7";"16"
"2014-05-31";"-151";"6";"3";"3";"1";"6";"13"
"2014-05-30";"-152";"6";"3";"3";"1";"6";"13"
"2014-05-29";"-153";"6";"3";"3";"1";"6";"13"
"2014-05-28";"-154";"5";"2";"2";"0";"5";"9"
"2014-05-27";"-155";"5";"2";"2";"0";"5";"9"
"2014-05-26";"-156";"5";"2";"2";"0";"5";"9"
"2014-05-25";"-157";"5";"2";"2";"0";"5";"9"
"2014-05-24";"-158";"4";"2";"2";"0";"4";"8"
"2014-05-23";"-159";"4";"2";"2";"0";"4";"8"
"2014-05-22";"-160";"4";"2";"2";"0";"4";"8"
"2014-05-21";"-161";"4";"2";"2";"0";"4";"8"
"2014-05-20";"-162";"3";"2";"2";"0";"3";"7"
"2014-05-19";"-163";"3";"2";"2";"0";"3";"7"
